+---+---+---+---+
|       |       |
+   +---+   +---+
|           |   |
+   +---+---+   +
|   |       |   |
+   +   +---+   +
|               |
+---+---+---+---+
