+---+---+---+---+
|           |   |
+   +---+   +   +
|   |           |
+---+   +---+   +
|       |   |   |
+   +---+   +   +
|       |       |
+---+---+---+---+
