+---+---+---+---+
|               |
+---+---+   +   +
|           |   |
+---+   +---+   +
|   |   |   |   |
+   +   +   +   +
|       |       |
+---+---+---+---+
