+---+---+---+---+
|           |   |
+---+   +---+   +
|               |
+   +---+   +   +
|   |   |   |   |
+---+   +---+   +
|               |
+---+---+---+---+
