+---+---+---+---+
|           |   |
+---+   +---+   +
|               |
+   +---+   +   +
|   |       |   |
+---+   +---+   +
|       |       |
+---+---+---+---+
