+---+---+---+---+
|       |       |
+   +   +   +---+
|   |           |
+   +---+---+---+
|               |
+---+---+---+   +
|               |
+---+---+---+---+
